111111111111111111111111
100000200000300000000001
100000200000300000000001
100020000003000220000001
100020000003000202000001
100020022203000202000001
100020000000000202000001
100000200000000220200001
122202200333332020000001
100000200000300020000001
100000200000300020000001
100022200000300020000001
100000220222300000000001
100000200000300000000001
122202200000322222022221
100000200000000000000001
100000222220000000000001
100030002002000333000001
100030002002000300300001
100030000002000300300001
100030000002000300300001
100033333330003000300001
100000000000003000300001
111111111111111111111111
